"filename", "language", "C", "comment", "blank", "total"
"f:\SRC\Hardware\SW-00002-CtrlBrd_v1.3_nodog\src\Cpuid_des.c", "C", 281, 33, 60, 374
"f:\SRC\Hardware\SW-00002-CtrlBrd_v1.3_nodog\src\Hm_bluetooth.c", "C", 704, 117, 120, 941
"f:\SRC\Hardware\SW-00002-CtrlBrd_v1.3_nodog\src\MPU6050_driver.c", "C", 128, 89, 41, 258
"f:\SRC\Hardware\SW-00002-CtrlBrd_v1.3_nodog\src\Usart_ble.c", "C", 142, 75, 50, 267
"f:\SRC\Hardware\SW-00002-CtrlBrd_v1.3_nodog\src\action.c", "C", 309, 142, 72, 523
"f:\SRC\Hardware\SW-00002-CtrlBrd_v1.3_nodog\src\comm.c", "C", 381, 85, 73, 539
"f:\SRC\Hardware\SW-00002-CtrlBrd_v1.3_nodog\src\error_event.c", "C", 2, 10, 7, 19
"f:\SRC\Hardware\SW-00002-CtrlBrd_v1.3_nodog\src\factory.c", "C", 7, 25, 4, 36
"f:\SRC\Hardware\SW-00002-CtrlBrd_v1.3_nodog\src\gpio.c", "C", 34, 41, 10, 85
"f:\SRC\Hardware\SW-00002-CtrlBrd_v1.3_nodog\src\i2c.c", "C", 430, 293, 134, 857
"f:\SRC\Hardware\SW-00002-CtrlBrd_v1.3_nodog\src\init.c", "C", 313, 165, 86, 564
"f:\SRC\Hardware\SW-00002-CtrlBrd_v1.3_nodog\src\main.c", "C", 21, 30, 12, 63
"f:\SRC\Hardware\SW-00002-CtrlBrd_v1.3_nodog\src\misc.c", "C", 436, 279, 132, 847
"f:\SRC\Hardware\SW-00002-CtrlBrd_v1.3_nodog\src\motor.c", "C", 257, 170, 88, 515
"f:\SRC\Hardware\SW-00002-CtrlBrd_v1.3_nodog\src\nrf24l01.c", "C", 85, 119, 35, 239
"f:\SRC\Hardware\SW-00002-CtrlBrd_v1.3_nodog\src\nrf24l01_drv.c", "C", 219, 212, 32, 463
"f:\SRC\Hardware\SW-00002-CtrlBrd_v1.3_nodog\src\packet.c", "C", 461, 137, 119, 717
"f:\SRC\Hardware\SW-00002-CtrlBrd_v1.3_nodog\src\param.c", "C", 82, 52, 33, 167
"f:\SRC\Hardware\SW-00002-CtrlBrd_v1.3_nodog\src\pid.c", "C", 109, 112, 42, 263
"f:\SRC\Hardware\SW-00002-CtrlBrd_v1.3_nodog\src\robot.c", "C", 556, 122, 115, 793
"f:\SRC\Hardware\SW-00002-CtrlBrd_v1.3_nodog\src\stm32f4xx_it.c", "C", 69, 108, 22, 199
"f:\SRC\Hardware\SW-00002-CtrlBrd_v1.3_nodog\src\system_stm32f4xx.c", "C", 141, 344, 71, 556
"f:\SRC\Hardware\SW-00002-CtrlBrd_v1.3_nodog\src\timer.c", "C", 77, 91, 38, 206
"f:\SRC\Hardware\SW-00002-CtrlBrd_v1.3_nodog\src\typedef.c", "C", 0, 12, 2, 14
"f:\SRC\Hardware\SW-00002-CtrlBrd_v1.3_nodog\src\usb_user\usb_bsp.c", "C", 271, 199, 99, 569
"f:\SRC\Hardware\SW-00002-CtrlBrd_v1.3_nodog\src\usb_user\usbd_cdc_vcp.c", "C", 197, 163, 46, 406
"f:\SRC\Hardware\SW-00002-CtrlBrd_v1.3_nodog\src\usb_user\usbd_desc.c", "C", 146, 132, 45, 323
"f:\SRC\Hardware\SW-00002-CtrlBrd_v1.3_nodog\src\usb_user\usbd_usr.c", "C", 42, 135, 40, 217
"f:\SRC\Hardware\SW-00002-CtrlBrd_v1.3_nodog\src\usb_user\usbh_usr.c", "C", 298, 280, 139, 717
"Total", "-", 6198, 3772, 1767, 11737